*****************************************
*...*.......*.......*...*.*...........*.*
***.*.*.*.*.*******.*.***.***.*.***.***.*
*.....*.*.*.............*...*.*...*.*...*
***.*.*.*.*.*.*****.*.*.*.***.*********.*
*.*.*.*.*.*.*...*.*.*.*.....*...*.......*
*.*.*****.*.***.*.*.***.*.*****.*****.***
*.......*.*.*.*.*.*.*.*.*...*.*...*.....*
*.*.*.*.***.*.*.*.***.*.***.*.*.*.***.*.*
*.*.*.*...*...*.*.*.*.....*.*.*.*.....*.*
*.*******.*******.*.*.*****.*.*.*.*.*****
*...*.....*.*.........*...*.*...*.*.....*
*****.*****.*********.*.*******.*.*****.*
*...*.....*...*.*.*...*.*...*...*.....*.*
***.*********.*.*.*.***.***.*****.***.***
*.*.........*.*.....*.*...*.*...*.*.....*
*.***.***.*.*.***.***.*.*.*.*.***.***.***
*.....*.*.*.*...*.......*.......*...*...*
*****.*.***.***.*.*****.*.*****.*.*****.*
*.*...*.........*.*.....*.*.....*...*...*
*.*.*******.***.*.***.*******.*.*.***.***
*.*.....*.....*.*...*.....*.*.*.....*.*.*
*.*****.***.***.*.*******.*.*.*******.*.*
*...*.*.*.*...*...*.*.......*.*.....*...*
*.***.*.*.*.*****.*.*.*****.***.***.***.*
*.....*.*.*.....*...*.*.*.....*...*.....*
*****.*.*.*.***.*****.*.*******.*******.*
*.*.....*...*.....*.*...*...*.......*...*
*.***.*.***.*******.*.*.***.***.*********
*.....*.*...*.....*.*.*...*.*.....*.*...*
*.*.***.*****.*****.***.***.*.***.*.***.*
*.*...*...*.*...*.*.*.*.*.......*.*.....*
***.***.***.***.*.*.*.*.*.*******.***.***
*.*...*...*.........*...*.*.....*.*.*...*
*.***.*******.***********.*.*.***.*.***.*
*.....*.........*...*...*...*...*.......*
***.*****.*.*******.***.*********.***.***
*.........*.....*.....*.......*.*...*...*
*.*.***.*.*****.***.***.*****.*.***.*****
*.*.*...*.....*...*.....*...............*
*****************************************
