*************************************************************
***.*.*.....*.*.........*.*.*...*...*.*.*...*...*.*.*...*.*.*
*.*.*.*.*****.***.*****.*.*.***.*.*.*.*.*.***.*.*.*.*.***.*.*
*.........*...*...*.......*.*...*.*.*.....*...*...*...*.....*
***.*.***.*.***.***.*****.*.*.***.***.***********.***.*****.*
*...*.*.......*...*.*.....*.........*.*.....*.*...*.........*
***.***.*.*.***.***.*****.*****.*.***.*****.*.***.*********.*
*...*...*.*...*...*.....*...*.*.*...*.*...*.....*.....*...*.*
*.*.*.*********************.*.***.***.*.*.*.***.*.*.*.***.*.*
*.*.*.......*.*...*.........*.*.....*.*.*.....*.*.*.*.....*.*
*.***.***.***.*.*.***.*****.*.***.***.***.*****.***.***.***.*
*...*...*.......*...*.*.*.*.*...*.*.*...*...*.......*.*.....*
*.***********.***.*.*.*.*.*.***.*.*.*.*.*.*.*******.*.*****.*
*.*...*...*...*.*.*.....*.........*...*...*.*.*...*.......*.*
***.*.*.*******.*.***.***.*.*.*.*****.*.***.*.***.*******.***
*...*...*.*.*.*...*.*...*.*.*.*.*...*.*...*...*...*.*...*.*.*
***.***.*.*.*.*.***.*.*.*.*********.*****.***.*.*.*.*.*****.*
*.*.*.....*.........*.*.*.*.....*...*...*.*.....*.*.........*
*.*.***.*********.*****.*.*****.***.***.*****.***.*****.***.*
*.....*.*.*...........*.*...*.*...........*.....*.....*.*.*.*
*.*.***.*.*****.***.*****.***.***.*****.***.***.*********.*.*
*.*.*.*.....*.....*.*.*...*...*.*.....*.*.....*...*...*.....*
*.*.*.*.*.***.***.***.*******.*.*.*******.*****.*****.*****.*
*.*.*...*...*...*.........*.*.....*...*...*.................*
*****.*******.***********.*.***.*****.*****.*.***.*******.***
*.....*.....*...........*.*.......*.......*.*.*.....*.....*.*
***.*******.*.***.*.*****.*.*****.*.*.*****.*******.*.***.*.*
*.....*.....*...*.*.*...*.*.....*...*.*.....*.*.*.*.*.*.....*
***.*****.*.***.*****.*****.*****.*.*.*.*.***.*.*.*.*.*.*.*.*
*.....*...*.*.......*.......*.....*.*.*.*...*.*...*.*.*.*.*.*
*.*****.*****.***********.***.*.*.*.*****.***.*.***.*********
*.........*.*.*.*.....*.*...*.*.*.*.*.*...*.......*.*...*...*
***.***.*.*.*.*.***.*.*.*.*****.*.***.*.*****.***.***.***.*.*
*...*...*...........*.....*.*...*.*...*.......*.*...*.....*.*
*****.*.*.*****.***.*.***.*.*.*.*****.***.*****.***.***.*****
*.....*.*.*...*.*.*.*...*...*.*.......*.......*.....*.*...*.*
*.*.*****.*.***.*.***.*****.*******.*****.*.***.*.***.*.***.*
*.*.....*.*.......*.*.*.....*.....*.......*...*.*.....*...*.*
***.*.***.*.*******.*************.*.*************.*.***.***.*
*...*...*.*.*.........*.*.*.*.....*.......*.*.*...*.*.......*
*.*********.***.*.*****.*.*.*.***.*.*******.*.***.***.***.***
*.*.*.*...*.....*.......*.*.....*.*.......*.....*.....*.*...*
***.*.***.*.*********.***.*****.*.*.***.*******.*****.*.***.*
*...*.....*.......*.*.....*...*.*.....*.*...*.*.*.........*.*
***.*.*.*.***.*****.***.***.*.***.*.***.*.***.*.*.*.*********
*.....*.*.*.....*.*.....*.*.*...*.*.*.*...*...*...*.....*...*
*.*******.*****.*.***.*.*.***.*****.*.*******.*******.***.*.*
*...*.......*.*.*...*.*.*.....*.*...*.*.......*...*.*.....*.*
*.*******.***.*.*.*.*********.*.***.*.*.*.***.***.*.*****.***
*...*.....*.......*.........*.*.........*...*...*.....*.*...*
*.*******.*.*****.*.*.*.***.*.*.*****.*****.*********.*.*.***
*.....*...*.*...*.*.*.*.*.....*.*.....*...*...*.*.*.....*...*
*.*.***.*.***.*.*.*********.*.*****.*.*.*****.*.*.***.*.***.*
*.*.*...*.*...*.....*.*.*...*.....*.*...*...*...*...*.*.*...*
*****.*.***.*****.***.*.***.***.*******.*.*****.***.*.*******
*.*.*.*.........*.*.*...*...*.*...*.......*.............*...*
*.*.***.*******.***.*.***.*.*.*.***.*.*.***.*.*****.*.***.***
*.*...........*...*.*.*.*.*...*...*.*.*.*...*...*...*.....*.*
*.*****.***.***.*.*.*.*.***.***.*.*.***.*******.***.*******.*
*.......*...*...*.*...........*.*.*.*...*.......*...........*
*************************************************************
